#####################################################################
#@..#...............................................................#
#...................................................................#
#####...............................................................#
#............#......................................................#
#...................................................................#
#...................................................................#
#...................................................................#
#...................................................................#
#...................................................................#
#...................................................................#
#...................................................................#
#...................................................................#
#...................................................................#
#...................................................................#
#...................................................................#
#...................................................................#
#...................................................................#
#...................................................................#
#...................................................................#
#...................................................................#
#...................................................................#
#...................................................................#
#####################################################################